4
W Empty W.png
E Wall E.png
T Empty T.png
S Empty S.png
40 30
EEEEEEEEEEEEEEEEEEEEEEEEEEEEEEEEEEEEEEEE
EWWWWWWWWWWWWWWWWWWWWWWWWWWWWWWEWWEEEEWE
EWEEEEEEEWEEEEEEEWEEEWEEEEEEEEWEWWWWWEWE
EWWWEWWWEWEWWWWWEWEWWWEEWWWWWEWEWEEEWWWE
EWEWEWEEEWEWEEEWEWEWEEEWWEEWEEWEWEEEWEEE
EWEEEWEWWWEWEWEWEWEWEWEEWEEWEEWWWWWEWWWE
EWWWWWEWEWEWEWWWEWEWEWEEWEWWWEEEEEWEEEWE
EEEEEEEWEWEWEEEEEWEWWWWWWEWEWWWWWEWEWEWE
EWEWWWWWEWEWWWWWWWEEWEEEEEWEEEEEWEWEEEWE
EWEWEWEEEWEEEEEEEEEEWEEEEEEEWWWWWEWWWEWE
EWWWEWEWWSWWEWWWEWWWWWWWWEEEEEEEEEEEWEWE
EWEEEWEWEWEWEWEEEWEEEEEEWWWWWWWEWWWEWEWE
EWEWWWEWEWEWWWWWEWEWWWWEWEEWEEWEEWEEWEWE
EWEEEWEWEWEEEWEWEWEEWEWEWEWWEEWWWWWWWWWE
EWEWEWWWEWEWWWEWEWEEWEWEWEWEEEEEEEEEEEEE
EWEWEEEEEWEEEEEEEWEEWEWEWEWEWWEEEEEEEEWE
EWWWWWWWWWWWWEEEEWEEWEWEWEWEEWEEWWWWWEWE
EWEEEEEEEEEEWEWWWWEEWEWEWEWEEWEEWEEEWEWE
EWEWWWEWWWWEWEWEEEEEWEWWWEWEEWWWWEEEWWWE
EWEWEWEWEEWEWWWEWWWEWEEEEEWEEEWEEEEEEEEE
EWWWEWEWEEWEEWEEEEWWWWWEWWWWWWWETWWWWEWE
EEEEEWEWWEWEEWEWEEEEEEWEEEEEEEEEEEEEWEWE
EWWWWWEEWEWEEWWWWWWWWEWEWWWWWEWWWWWWWWWE
EWEEEEEEWEWEEEWEEEEEEEWEWEWEEEWEEWEEWEEE
EWEWEEEEWEWWWEWEEEEEWEEEWEWEWWWEEWEEWWWE
EWEWWWWWWEEEWEWWWWWWWEWWWEWEWEEEEWEEEEEE
EWEEEEEEWEWEWEEEWEEEWEEEWEWEWEWWWWWWWWWE
EWWWWWWWWEWWWWWWWEEEWWWWWEWWWEWEEEEEEEEE
EEEEEEEEEEEEEEEEEEEEEEEEEEEWWWWWWWWWWWWE
EEEEEEEEEEEEEEEEEEEEEEEEEEEEEEEEEEEEEEEE
