7
S Wall S.png
A Wall A.png
F Empty F.png
R Empty R.png
E Empty E.png
T Empty T.png
P Empty P.png
30 30
AASSSSAAASAAAASAAAAASAASSSSSSS
AFFFFFFFFFFFFFFFFFFFFFFFFFFFFS
AFTFFFFFFFFFFFFTFFFFFFFFFTRFFS
AFAASAAASSASASSSASFFFFFFFFRRFS
SFAFFFFFFFFSFFFFFSSASSSASFFTFS
AFAFFFFFFFFSFFTFFSFFFFFFAFFRFS
AFSFFFFRFFFFFFFRRFFFRRFFSFTRFA
AFSFFTRFFFFFFFFTTFFRFTRFFFRRFA
ARSFFFFFFFFSFFFFFAFFFFFFFRRFFS
SFAFFSAAAASSSAAAASSSAAAAAFFFFS
AFAFFFFFFFFFFFFFAFFFFFFFSFFFFA
AFAFRTFFFFFFTTFFFFFTFFFFSFFFFA
SRSFFFRRFFFTFFFFFFFRRFFFSASSAA
ARSFFFFFFFFFFFFFSFFTFRFFAFFFFS
ATSAAASSASSSAAAASFFFFFRFFFFFFS
ARPFRRFFFFSFFFFFSFFFFFFFFTRFFA
AFAFFFRFFFAFRRRFSFFFFFFFAFRFFA
AFSFFFFRFFFFTFTFAAASSSSSAFFRFA
SFSFFFFRFFFFRFRFSFFFFFFFAFFTFA
AFSFFFRRFFSFRTRFFFRRTRFFAFFRFS
ARAFFRFFFFAFFFFFAFFFFRTFFFFRFS
AFSSAFFAAASSSSAAAAASSSRFFFFRFA
AFAFFFFFFFAFFFFFFFFFFAFFSFFFFA
AFSFRFFRFFSFRFFRFFFRFAFFSFFFFA
SFSFRFFRFFAFFFRFFFFRFAAAAAAAAA
ATSFFTRFRFAFFRRFRRFFFAFFFFFFFA
ATSFFRTFRFFFFFRFFFRFFFFFFFFFFA
AFSFFRFRRFSFFRFRRFRFFAFFFFFFFA
AEAFFFFFFFSFFFFFFFFFFAFFFFFFFA
AAAASAAAAAASAASSAASAAAAAAAAAAA
