17
B Wall B.png
P Empty P.png
R Empty R.png
S Wall S.png
A Wall A.png
E Empty E.png
G Empty G.png
C Wall C.png
V Empty V.png
L Empty L.png
U Empty U.png
N Empty N.png
M Empty M.png
X Empty X.png
T Empty T.png
Z Empty Z.png
Y Empty Y.png
40 30
BBBBBBBBBBBBBBBBBBBBBBBBBBBBBBBBBBBBBBBB
BBPPPPPPPPPPPPPPPPPPPPPPPPPPPPPPPPPPPPBB
BPPRRRRRRRRRRRRRRRRRRRRRRRRRRRRRRRRRRPPB
BPRRRRRRRRRRRRRRRRRRRRRRRRRRRRRRRRRRRRPB
BPRRRPPPPPPPPPPPPRRPPPPPPPPPPPPPPPPRRRPB
BPRRPBBBBBUBBBBBPRRPSSSUSSSSUSSYYYPPRRPB
BPRRPBUUUUUUUUUBPRRPSSUUUUUUUUSYYYYPRRPB
BPRRPBNMUUUUUUUBPRRPSSUUUUUUUUSSSSSPRRPB
BPRRPBUUUUUUUUUBPRRPSSUUUUUUUUUUUUSPRRPB
BPRRPBNMUUUUUUUBPRRPSSUUUUUUUUUUUUSPRRPB
BPRRPBUUUUUUUUUBPRRPSSUUUUUUUUUUUUSPRRPB
BPRRPBNMUUUUUUZBPRRPSSUUUUUUUUUUUUSPRRPB
BPRRPBBBBBBBBBBBPRRPSSSSSSSSSSSSUSSPRRPB
BPRRPPPPPPPPPPPPPRRPPPPPPPPPPPPPPPPPRRPB
BPRRRRRRRRRRRRRRRRRRRRRRRRRRRRRRRRRRRRPB
BPRRRRRRRRRRRRRRRRRRRRRRRRRRRRRRRRRRRPPB
BPRRREYYYYYYYYYYYYYYYYYYYYYYYYYYYYYYYVVB
BPRREEPPPPPYYYYYYYPPPPPYYYYYYYYEYYGYVEEB
BPRREPPAUAPPYYYYYPPAAAPPYYYYYGYYGYVVVEEB
BPRRPPATTTAPPPPPPPAXXTAPPYYGYYEGYVVEEGEB
BPRRPATTTTXAAAAAAAXXTZZAPYYYYCYCCEEEEEEB
BPRRPATTTTTXXXXXXXTTZZLAPYYECVGEEECGEEEB
BPRRPATTTTXAAAAAAAXXTZZAPYGYCVEEGECEGEEB
BPRRPPATTTAPPPPPPPAXXTAPPYYYCEVEEECEEEEB
BPRRRPPAAAPPYYYYYPPAAAPPYYEVCGEEEVCEEEEB
BPRRRRPPPPPYYYYYYYPPPPPPYEYYECECCCEEXGEB
BPRRRRRRRRRRRRRRRRRRRRPPYYVEEEEEEEEEEEEB
BPPRRRRRRRRRRRRRRRRRRPPPYYEGEEGEEEXEEEEB
BBPPPPPPPPPPPPPPPPPPPPPEEEEEEEEEEEEEEEBB
BBBBBBBBBBBBBBBBBBBBBBBBBBBBBBBBBBBBBBBB
